Picobot2	KEYWORD1
forward	KEYWORD2
reverse	KEYWORD2
stop	KEYWORD2
spinLeft	KEYWORD2
spinRight	KEYWORD2
turnForward	KEYWORD2
turnReverse	KEYWORD2
lineRead	KEYWORD2
lightRead	KEYWORD2
buttonRead	KEYWORD2
distanceRead	KEYWORD2
pixelBrightness	KEYWORD2
pixelOff	KEYWORD2
pixelSet	KEYWORD2
pixelAllOff	KEYWORD2
pixelAllSet	KEYWORD2
setBlueLED	KEYWORD2
RESERVED_WORD_2
OFF	LITERAL2		LITERAL_BOOLEAN
RESERVED_WORD_2
ON	LITERAL2		LITERAL_BOOLEAN
